111111111111111111111111111111111
100000000000000010000000001001001
10000000001111111111110000100000111111
1000000000000000P000000000100000111111
10000000000000010000000000000100000001
11111111111111111111111111111111111111