111111111111111111111111111111111
1P0000000000000000000000000001001
10000000000000000000000000000000111111
10000000000000000000000000000000111111
10000000000000000000000000000000000001
11111111111111111111111111111111111111