1111111111111111111111111
1V000000000V0000000000001
1011001110000001110011101
1001000010011100010000101
100100111001C101110000101
1001000010010100010000101
1011101110000001110000101
100000000000P000000000001
1000000000000000000000001
1011101110011100011100001
1000101010000100000100001
1011100000011100011100001
101000101001000001C000001
1011101110011100011100001
10000000000000V00000000E1
1111111111111111111111111
