1111111111111111111111111111111111
1C00P000000000000000000CC0000000E1
111111111111111111C111111111111111
1111111111111111111111111111111111
