11111111111111111111111111
1CCCCCCCCCCC11CCCCCCCCCCC1
1C1111C1111C11C1111C1111C1
1C1111C1111C11C1111C1111C1
1C1111C1111C11C1111C1111C1
1CCCCCCCCCCCCCCCCCCCCCCCC1
1C1111C1C11111111C1C1111C1
1CCCCCC1CCCC11CCCC1CCCCCC1
111111C111101101111C111111
111111C10V0000000V1C111111
111111C101110011101C111111
10CCCCC00100CC00100CCCCCE1
111111C101111111101C111111
111111C1V000000V001C111111
111111C101111111101C111111
1CCCCCCCCCCC11CCCCCCCCCCC1
1C1111C1111C11C1111C1111C1
1CCCCCCCCCCC0PCCCCCCCCCCC1
11111111111111111111111111
