11111111111111111111111111
1C1CCCCCCCCC11CCCCCCCCCCC1
1C1111C1111C11C1111C1111C1
1C1111C1111C11C1111C1111C1
1C1111C1111C11C1111C1111C1
1VCCCCCCCCCCCCCCCCCCCCCCC1
1C1111C1C11111111C1C1111C1
1CCCCCC1CCCC11CCCC1CCCCCC1
111111C111101101111C111111
111111C10V000000001C111111
111111C101110011101C111111
10CCCCC001000000100CCCC0E1
111111C101111111101C111111
111111C1000000V0001C111111
111111C101111111101C111111
1CCCCCCCCCCC11CCCCCCCCCCC1
1C1111C1111C11C1111C111111
1CCC11CCCCCC0PCCCCCC00C0C1
11111111111111111111111111
