111111111111
10000C000CC1
1CCCCECCCCC1
1CCC0C000001
1P0000C00001
111111111111
